S*************************************S*SS
S***************SSS*******************SSSS
S*******S***S***********************SSSSSS
S*****SSSS**S***SSSS******************S*SS
S*******S***S****SS***********S*SSS***SSSS
SS***********************************SSSSS
SSSSSSSSSSSSSSSSSSSSSSSSSSSSSSSSSS**SSSSSS
******************************************
SSSSSSS*SSSSSSSSSSSSSSSSSSSSSSSSSSSSSSSSSS
SSSSSSS*SSSSSSSSSSSSSSSSSSSSSSSSSSSSSSSSSS
SSS**********************************SSSSS
SSSSSSSSSSSSSSSSSSSSSSSSSSSSSSSSSSSSSSSSSS
SSSSSSSSSSSSSSSSSSSSS*********************
SSSSSSSSSSSSSSSSSSSSSSSSSSSSSSSSSSSSSSSSSS
SSSSSSSSSSSSSSSSSSSSSSSSSSSSSSSSSSSSSSSSSS
