S*************************************S*SSSS
S***************SSS*******************SSSSSS
S*******S***S***********************SSSSSSSS
S*****SSSS**S***SSSS*************E****S*SSSS
S*******S***S****SS***********S*SSS***SSSSSS
SS********************E**************SSSSSSS
SSSSSSSSSSSSSSSSSSSSSSSSSSSSSSSSSS**SSSSSSSS
******************************************SS
SSSSSSS*SSSSSSSSSSSSSSSSSSSSSSSSSSSSSSSSSSSS
SSSSSSS*SSSSSSSSSSSSSSSSSSSSSSSSSSSSSSSSSSSS
SSS**********************************SSSSSSS
SSSSSSSSSSSSSSSSSSSSSSSSSSSSSSSSSSSSSSSSSSSS
SSSSSSSSSSSSSSSSSSSSS*********************SS
SSSSSSSSSSSSSSSSSSSSSSSSSSSSSSSSSSSSSSSSSSSS
SSSSSSSSSSSSSSSSSSSSSSSSSSSSSSSSSSSSSSSSSSSS
