SSSSSSSSSSSSSSSSSSSSSSSSSSSSSSSSSSSSSSSSSSSSSSSSSSSSSSSSSSSSSSSSSSSSSSSSSSSSSSSSSSSSSSSSSSSSSSSSSSSSSSSSSSSSSSSSSSSSS
S*******************************************************************************************************************S
S*******************************************************************************************************************S
S*******************************************************************************************************************S
S********************************E**********************************************************************************S
S*******************************************************************************************************************S
S*******************************************************************************************************************S
S*******************************************************************************************************************S
*********************************************************************************************************************
S*******************************************************************************************************************S
S*******************************************************************************************************************S
S*******************************************************************************************************************S
S*******************************************************************************************************************S
S*******************************************************************************************************************S
S*******************************************************************************************************************S
S*******************************************************************************************************************S
S*******************************************************************************************************************S
S*******************************************************************************************************************S
S*******************************************************************************************************************S
S*******************************************************************************************************************S
S*******************************************************************************************************************S
S*******************************************************************************************************************S
S*******************************************************************************************************************S
S*******************************************************************************************************************S
S*******************************************************************************************************************S
S*******************************************************************************************************************S
S*******************************************************************************************************************S
S*******************************************************************************************************************S
S*******************************************************************************************************************S
S*******************************************************************************************************************S
S*******************************************************************************************************************S
S*******************************************************************************************************************S
S*******************************************************************************************************************S
S*******************************************************************************************************************S
S*******************************************************************************************************************S
S*******************************************************************************************************************S
S*******************************************************************************************************************S
S*******************************************************************************************************************S
S*******************************************************************************************************************S
S*******************************************************************************************************************S
S*******************************************************************************************************************S
S*******************************************************************************************************************S
S*******************************************************************************************************************S
S*******************************************************************************************************************S
S*******************************************************************************************************************S
SSSSSSSSSSSSSSSSSSSSSSSSSSSSSSSSSSSSSSSSSSSSSSSSSSSSSSSSSSSSSSSSSSSSSSSSSSSSSSSSSSSSSSSSSSSSSSSSSSSSSSSSSSSSSSSSSSSSS
