SSSSSSSSSSSSSSSSSSSSSSSSSSSSSSSSSSSSSSSSSSSSSSSSSSSSSSSSSSSSSSSSSSSSSSSSSSSSSSSSSSSSSSSSSSSSSSSSSSSSSSSSSSSSSSSSSSSSS
S*******************************************************************************************************************S
S*******************************************************************************************************************S
S*******************************************************************************************************************S
S********************************E**********************************************************************************S
S*******************************************************************************************************************S
S*******************************************************************************************************************S
S*******************************************************************************************************************S
*********************************************************************************************************************
S*******************************************************************************************************************S
S*******************************************************************************************************************S
S*******************************************************************************************************************S
S*******************************************************************************************************************S
S*******************************************************************************************************************S
S*******************************************************************************************************************S
S*******************************************************************************************************************S
S*******************************************************************************************************************S
S*******************************************************************************************************************S
S*******************************************************************************************************************S
S*******************************************************************************************************************S
S*******************************************************************************************************************S
S*******************************************************************************************************************S
S*******************************************************************************************************************S
S**************************************************************************************SSSSSSSSSSSSSSSSSSSSSSSSSSSSSS
S**************************************************************************************SSSSSSSSSSSSSSSSSSSSSSSSSSSSSS
S**************************************************************************************SSS*************************SS
S**************************************************************************************SSS*************************SS
S**************************************************************************************SSS*************************SS
S**************************************************************************************SSS*************************SS
S**************************************************************************************SSS*************************SS
S**************************************************************************************SSS*************************SS
S**************************************************************************************SSS*************************SS
S**************************************************************************************SSS*************************SS
S**************************************************************************************SSS*************************SS
S**************************************************************************************SSS*************************SS
S**************************************************************************************SSS*************************SS
S**************************************************************************************SSS*************************SS
S**************************************************************************************SSSSSSSSSSS********SSSSSSSSSSS
S**************************************************************************************SSSSSSSSSSS********SSSSSSSSSSS
S********************************************************************************************************************
S********************************************************************************************************************
S********************************************************************************************************************
S********************************************************************************************************************
S********************************************************************************************************************
S********************************************************************************************************************
SSSSSSSSSSSSSSSSSSSSSSSSSSSSSSSSSSSSSSSSSSSSSSSSSSSSSSSSSSSSSSSSSSSSSSSSSSSSSSSSSSSSSSSSSSSSSSSSSSSSSSSSSSSSSSSSSSSSS
