*******************************************
*******************************************
*******************************************
*******************************************
X******************************************
X******************************************
X******************************************
X******************************************
X******************************************
X******************************************
X******************************************
X******************************************
X******************************************
XXXXXXXXXXXXXXXXXXXXXXXXXXXXXXXXXXXXXXXXXXX
