S*************************************SS
S***************SSS*******************SS
S*******S***S***********************PPSS
S*****SSSS**S**SSSSSS*****************SS
S*******S***S*****************SSSSS***SS
SS***********************************SSS
SSSSSSSSSSSSSSSSSSSSSSSSSSSSSSSSSSSSSSSS
SSSSSSSSSSSSSSSSSSSSSSSSSSSSSSSSSSSSSSSS
SSSSSSSSSSSSSSSSSSSSSSSSSSSSSSSSSSSSSSSS
SSSSSSSSSSSSSSSSSSSSSSSSSSSSSSSSSSSSSSSS
