*************************************
***************SSS*******************
*******S***S*************************
*****SSSS**S**SSSSSS*****************
*******S***S*****************SSSSS***
S***********************************S
SSSSSSSSSSSSSSSSSSSSSSSSSSSSSSSSSSSSS
